====================
|<                 |
|                  |
| ===|             |
|    |             >
|    |             |
| ===|             |
|~                 |
====================
