====================
=0                 =
=                  =
= ===|             =
=    |             =
=    |             =
= ===|             |
=                  |
====================
