==============================
|X |      |         |        |
|  |===|  |=|  |====|  |==|  | 
|              |       |==|  | 
|  |====|  |=====|  |  |==|  
|  |    |           |  |==|  |
|  |==  |  |========|  |  |  |
|       |      |       |     |
==============================
