====================
|<    |            |
|     |            |
|     |            |
|     |            >
|     |            |
|  ===|            |
|~                 |
====================
