====================
=0                 =
=                  =
= ===|             =
=    |             =
=    |             =
= ===|             =
=                  =
====================
