====================
|<                 |
|    |             |
|    |             |
|    |    ==|      >
|    |      |      |
| ===|      |      |
|~          |      |
====================
