==============================
=0 =      =         =        =
=  =====  ===  ======  ====  = 
=              =       =  =  = 
=  ======  =======  =  =  =  
=  =    =           =     =  =
=  ===  =  ==========  =  =  =
=       =      =       =     =
==============================
